%%%%%%%%%%%%%%%%%%%%%%%%%
%......................G%
%.                     .%
%.                     .%
%.                     .%
%. P                   .%
%.                     .%
%.                     .%
%.                     .%
%.                     .%
%.                     .%
%.                     .%
%G.....................G%
%%%%%%%%%%%%%%%%%%%%%%%%%
