%%%%%%%%%%%%%%%%%%%%%%%%%
%.. P  ....      ....  G%
%..  ...  ...  ...  ... %
%..  ...  ...  ...  ... %
%..    ....      .... G %
%..  ...  ...  ...  ... %
%..  ...  ...  ...  ... %
%..    ....      ....  o%
%..    ....      ....  G%
%..    ....      ....  o%
%..    ....      ....  G%
%..    ....      ....  o%
%..    ....      ....  G%
%%%%%%%%%%%%%%%%%%%%%%%%%
